1111111111
1000001001
1001001001
1001001001
1001000001
1P01000001
1000E0C001
1111011111
1000C00001
1111111111
