11111111111
10000000C01
1E000000001
100000000P1
11111111111no