1111111111
1000001001
1001001001
1001001001
1001000001
1P00000001
10C00E0001
1111111111
1000000001
1111111111