1111111111
1000001001
1001001001
1001001001
1P01000001
1000000001
1C00000001
1111E11111
10000C0001
1111111111